9
16
7 11 11 11 11 11 11 11 11 11 11 11 11 11 11 7
10 0 0 0 0 0 0 0 0 0 0 0 0 0 0 9
10 0 0 0 0 0 0 0 0 0 0 0 0 0 0 9
10 0 0 0 0 0 0 0 0 0 0 0 0 0 0 9
10 0 0 0 0 0 0 0 0 0 0 0 0 0 0 9
10 0 0 0 0 0 0 0 0 0 0 0 0 0 0 9
10 0 0 0 0 0 0 0 0 0 0 0 12 8 8 7
7 8 8 8 8 8 8 8 8 8 8 8 7 7 7 7
7 7 7 7 7 7 7 7 7 7 7 7 7 7 7 7
